1111111
1000001
1000001
1100011
1111001
1-P0CE1
1111111
