11111111111111
100C00C0000001
100E0P10P10C01
10000C000P1001
100100PE000C01
11111111111111
